##########
.........#
######.###
#......###
#.####.###
#.........
##.#######
##.##.####
##...#####
#######.##